  1111111111
 1100000001
   100000011
11110000011
1111111111
