F 116,51,255
C 51,111,255

NO ./sprites/Impression_Sunrise.png
SO ./sprites/wall.png
WE ./sprites/glass.png
EA ./sprites/Wheat_Field.png

1111111111 111111111111
10100000011100000000001
10111000000000000000001
10100000011100000000001
101110N001 100000000001
1010000001 110011111111
100000000010000001
111111111111111111 111
                   111
1       1          111
