1111
1111111
1111111111111
1000000000001
1000000000001
1000000000001
1000001000001
1000000000001
1000000000001
1000010100001
100000N000001
1111111111111
