1111
1111111
1111111111111
1000000000001
1000000001001
1000000000001
1000000000001
100010N000001
1000000000001
1000000000001
1000000000001
1111111111111
