1111
1111111
1111111111111
1000000000001
100000N001001
1000000000001
1000000000001
1000110010001
1001000001001
1000000000001
1000000000001
1111111111111
