

    111
111 101
    111
1
111111111111
 11000000011
  10100010011
  1000000011
111000N0011
1111111111