

    111
111 101
    111
1
111111111111
 1100000001
  1100010011
111100N0011
1111111111
