
11111111111
10000000001
10000000001
10010001001
10000000001
10000N00001
11111111111
