1111
1111111
111111111111
100000000001
100000000001
100000000001
100100000001
100100000001
100100010001
100000000001
10000N000001
111111111111
